%%%%%
%%.G%
%.%%%
% . %
%. .%
%   %
%  .%
%   %
%P .%
%%%%%
